9 5
#####
#   #
# # #
#*  #
## ##
#   #
# # #
#   #
#####
