5 30
##############################
# * ##   ##   ##   ##   ##   #
# #    #    #    #    #    # #
#   ##   ##   ##   ##   ##   #
##############################
